EA	./assets/walls/1.xpm
NO	./assets/walls/2.xpm
SO	./assets/walls/3.xpm
WE	./assets/walls/4.xpm

C 225,30,0
F 256,10,0

1111111111
1000000001 
1000000001 
1000000001
1011111111
1S1
111
