EA	./assets/walls/1.xpm
NO	./assets/walls/2.xpm
SO	./assets/walls/3.xpm
WE	./assets/walls/4.xpm

C 0,206,209
F 255,165,0
 
1111111111111111111111111111111111111111 
1111111111111111111111111111111111111111 
100000000000000G00001000000000001111111
100000000000000001000000000000011111
1111111D1111110010000000G00000011111
11000G0000000001111D100111111D1111111
1000000001111D111100111111111001111
101111110111101111001       1001
101000010111000010001       1001 
111000010100000000111   11111001
1000000111111111D1111   1E000001
111111110000000000001   11111001
       11111111111001       1001111111111111111111111
             111111D111111111D11111111111111111111111
             10000000000000G00000010000000G0001111111
       1111111D1111111111111D111111111111111111111111
       110000000000001111110011111111111111
       1000G00000011D111100000001
       10111111D11110111100000001
       10100000011100G0D000111111
       100G00001000000001111111
       11D1111111D1111111
       1000000G000001
       11111111111001
                 1111
