EA	./assets/walls/1.xpm
NO	./assets/walls/2.xpm
SO	./assets/walls/3.xpm
WE	./assets/walls/4.xpm

C 225,30,0
F 256,10,0

111111
1S0001 
100001 
100001
101111
101
111
