EA	./assets/walls/1.xpm 


NO	./assets/walls/2.xpm
SO	./assets/walls/3.xpm
WE	./assets/walls/4.xpm

C 225,30,0
F 256,10,0

1111111111111111111111111111111111111111
1E0000000000000G00001000000000001111111
100000000000000001000000000000011111
1111111D1111110010000000G0000000000111
11000G0000000001111110011111111111111
1000000001111D1111001111
101111110111101111001
101    10111000010001
111    10100000000111
       111111111D11111
       10000000000001
       11111111111001
              11111D1111111111111111111111111111111111
              1000000000000G00000010000000G0001111111
       1111111D1111111111111D111111111111111111111
       1100000000000001111110011111111111111
       1000G00000011D111100000001
       10111111D11110111100000001
       10100000011100G01000111111
       100G00001000000001111111
       11D1111111D11111111111
       1000000G000001
       11111111111001
                 1111
