EA	./assets/walls/1.xpm 


NO	./assets/walls/2.xpm
SO	./assets/walls/3.xpm
WE	./assets/walls/4.xpm

C 225,30,0
F 256,10,0

1111111111111111111111111111111111111111
1E0000000000000000001000000000001111111
100000000000000001000000000000011111
1111111D111111001000000000000000000111
1100000000000001111110011111111111111
1000000001111D1111001111
101111110111101111001
101    10111000010001
111    10100000000111
       111111111D11111
       10000000000001
       11111111111001
              11111D1111111111111111111111111111111111
              100000000000000000001000000000001111111
       1111111D1111111111111D111111111111111111111
       1100000000000001111110011111111111111
       1000000000011D111100000001
       10111111D11110111100000001
       10100000011100001000111111
       100000001000000001111111
       11D1111111D11111111111
       10000000000001
       11111111111001
                 1111
