NO	./assets/walls/1.xpm
EA	./assets/walls/1.xpm
SO	./assets/walls/1.xpm
WE	./assets/walls/1.xpm

C 225,30,0
F 256,10,0

1111111
1000001
10000001
10000N1
1111111
