EA	./assets/walls/1.xpm
NO	./assets/walls/2.xpm
SO	./assets/walls/3.xpm
WE	./assets/walls/4.xpm

C 225,30,0
F 256,10,0

111111111111111111111
100000000000000000001
100000000000111111001
100000000111111111001
101111110111111111001
1N1    101       1001
111    101       1001
       10111111111001
       10000000000001
       11111111111001
                 1111
