EA	./assets/walls/1.xpm
NO	./assets/walls/2.xpm
SO	./assets/walls/3.xpm
WE	./assets/walls/4.xpm

C 225,30,0
F 256,10,0

111111111111111
1000011000000001
1101001000000111111
11111000001100000011
    100001110000001 1
11111000000000000001 1
1111111000000001111111
1   1111000001100000011
    10000111000000111 1
    10000000000001 1
   11111100000011111 1
111000001100000011
   1100001110000001 1
 111110000000000001 1
110000000W00111111111
  111101000001100000011
    10000111000000111
    10000000000001 1
11110000000111111
1000001100000011
100001110000001 1
10000000000001111
11111111111111 1
101
111
