EA ./assets/walls/1.xpm
NO ./assets/walls/2.xpm
SO ./assets/walls/3.xpm
WE ./assets/walls/4.xpm
C 225,30,0
F 256,10,0
11111111111111111111111111111111111111111111111111111
11111110111111111111111111111111111111111111111111111
100000000000000G0000100000000000111111111111111111111
10000000000000000100000000000001111111111111111111111
1111111D1111110010000000G0000000000111111111111111111
11000G0000000001111D100111111D1111111 111111111111111
1000000001111D111100111111111001111 111111111111111
101111110111101111001 1001111111111111111111111
101 10111000010001 1001111111111111111111111
111 10100000000111 1001111111111111111111111
111111111D11111 1001111111111111111111111
1000000000000111111 10011111111111111111
11111111111111111001 1001111111111111111
111111 111111D111111111D11111111111111111
1111111111110000000000000G00000010000000G0001
1111111D1111111111111D111111111111111111111111
1100000000S00001111110011111111111111
1000G00000011D111100000001
10111111D11110111100000001
10100000011100G0D000111111
100G00001000000001111111
11D1111111D11111111111
1000000G000001
11111111111001
11111111111111
