111111
100001
101001
1N0001
111111
