111111
100001
10111
1001
10101
1N0001
100001
111111