111111
1  IJK 1
100001
1010001
1N0000001
1000000001
111111